あまがみあさひ	甘神朝姫	人名	甘神さんちの縁結び
あまがみ	甘神	姓	甘神さんちの縁結び
あさひ	朝姫	名	甘神さんちの縁結び
しらひ	白日	名	甘神さんちの縁結び
よみこ	宵深子	名	甘神さんちの縁結び
あいじょうれんたろう	愛城恋太郎	人名	君のことが大大大大大好きな100人の彼女
あいじょう	愛城	姓	君のことが大大大大大好きな100人の彼女
れんたろう	恋太郎	名	君のことが大大大大大好きな100人の彼女
いんだからね	院田唐音	人名	君のことが大大大大大好きな100人の彼女
からね	唐音	名	君のことが大大大大大好きな100人の彼女
とおか	十花	名	中二病でも恋がしたい！
にぶたに	丹生谷	名	中二病でも恋がしたい！
ゆうた	勇太	名	中二病でも恋がしたい！
しちみや	七宮	名	中二病でも恋がしたい！
りっか	六花	名	中二病でも恋がしたい！
まけいん	負けイン	固有名詞	負けヒロインが多すぎる！
しうんじ	紫雲寺	姓	紫雲寺家の子供たち
あらた	新	名	紫雲寺家の子供たち
せいは	清葉	名	紫雲寺家の子供たち
おうか	謳華	名	紫雲寺家の子供たち
しおん	志苑	名	紫雲寺家の子供たち
じーくあくす	GQuuuuuuX	固有名詞	機動戦士Gundam GQuuuuuuX
